111111111111111111111111111
000101010100000001000000001
100101010101111111011111111
100000000000000101010000001
100111111101110101011111001
100001000100010000010001001
111101110111111111010111001
100001000100010000000001001
100111010101111111111101001
100000010100000001010001001
111111111101110111011101001
100000000001010100010100001
100101010101010101110111001
100101010100010100000000001
100101111101011101110101001
100100010001000000010101001
111111011111011111111101111
100001000001010001000101001
111101011101110111110101001
100000000100010101010000001
111101111101110101011101001
100100000100000001000001001
100101110111110101110111111
100101010001010101010101001
100101010111011101011101001
100001000001000000010100001
100111011101000001110101001
100001010001000001010001001
111111011111010111011101001
100100000001010001000101001
100111110101111101010101001
100001000101000001010001001
100111110111111101110111001
100101000100000000010001001
100101111111111111010101111
100001000001000000000101001
111101010111011101110111001
100100010101000100010100001
100111011101011101110111001
100101010001000101010000001
100101010101111111010111001
100000010100010000000101001
111111011101111111011101001
100000010000010101000100001
111101010101110101011111111
100101000100000000000000001
100111110111011111011111111
100100000100010100010001001
100101011101110111010101001
100001010001000000000100001
111111111111111111111111111