███████████████████████████
█    █ █ █   █ █          █
█ ████ █ █ █ █ █ ███████  █
█    █     █ █       █ █  █
████ ███ █████ █ █████ █  █
█      █ █ █ █ █     █    █
█  █ ███ █ █ █ █ █ █████  █
█  █ █     █ █ █ █   █ █  █
████ █ ███ █ █ ███ ███ █  █
█  █ █ █   █   █ █   █    █
█  █ █ █ █ █ ███ ███ ██████
█                       ███
████ █ █████ ███████████  █
█    █ █       █   █ █    █
█  ███████████ █ █ █ █ █  █
█      █     █   █ █   █  █
████████████ █ █ █████ ████
█  █ █       █ █     █    █
█  █ █████ █████ █████ ████
█        █     █ █   █    █
█  █ ███ █ ███ █ ███ ███  █
█  █ █ █   █ █ █ █     █  █
██████ █ ███ ███ ███ ██████
█      █                  █
█  ███ █ ███   █████████  █
█  █             █ █ █    █
████████ █ █   █ █ █ ███  █
█    █   █ █   █   █ █ █  █
█  ███ ███████ █████ █ █  █
█   █     █   █   █   █   █
█  █ █ █ █████████ ███ █  █
█  █   █ █           █    █
█  ███ █████████████ ███  █
█  █   █       █ █ █   █  █
████████████ █ █ █ █ █ █  █
█    █   █   █       █    █
█  ███ ███ █████ █████ ████
█    █ █   █ █   █ █      █
█  ███ ███ █ █ ███ █ █ ████
█  █       █ █ █     █ █  █
█  █ ███████ ███ █ ███ █  █
█         █ █   █ █       █
█  █ ███ ███ ███████ ██████
█  █ █         █     █    █
█  █ ███ █ █ ███████ █ █  █
█  █   █ █ █ █       █ █  █
█  ███████████████ █████  █
█            █     █ █    █
████ █████ █ ███ ███ █ █  █
█    █     █ █         █  █
███████████████████████████
