######################### #
#  #     #  #        #    #
#  ####  #  #  #######    #
#           #  #          #
#  ####  ####  ####  #    #
#  #        #  #     #    #
##########  #  #######    #
#  #  #  #     #     #    #
#  #  #  #  #  #  ####    #
#        #  #             #
#  #  ##########  ####    #
#  #        #  #     #    #
#######  ####  #######    #
#  #  #           #       #
#  #  #  #  #  ####  #    #
#        #  #        #    #
#  #  #  #  #######  #    #
#  #  #  #        #  #    #
####  #  ####  #  ####    #
#  #  #  #     #     #    #
#  #  #######  ############
#     #  #     #          #
#  ####  ####  #######    #
#  #  #           #       #
####  #  #######  ####    #
#  #     #        #       # 
#  #  #######  #######    #
#     #              #    #
####  ####  ####  #  #    #
#     #        #  #       #
####  #  #############    #
#     #        #          #
#######  ##########  #    #
#  #     #     #  #  #    #
#  #  #  #  ####  #########
#     #  #     #  #       #
#  ####  ####  #  #  #    #
#  #        #  #     #    #
####  ####  #  #  #  #    #
#  #  #           #  #    #
#  #  #######  ############
#     #     #  #          #
####  #  #  #  #  #  ######
#  #  #  #  #  #  #  #    #
#  #  #  #  #  #  #  #    #
#     #  #  #  #  #  #    #
#  #  ####  #######  #    #
#  #        #  #          #
#  #  #  #  #  ####  #    #
#  #  #  #           #    #
#  #  #  #           #    #
###########################